[
    {
        "spawnPoints": [
            [13, 22],
            [29, 22],
            [45, 22]
        ],
        "playerSpawnsPos": [
            { "x": 25, "y": 40 },
            { "x": 33, "y": 40 }
        ],
        "npc": [0, 0, 0, 0, 0, 0, 0, 0, 0, 0, 0, 0, 0, 0, 0, 0, 0, 0, 0, 0],
        "map": [
[7,7,  7,7,  3,3,  3,3,  3,3,  7,7,  7,7,  7,7,  7,7,  7,7,  7,7,  7,7,  7,7,  7,7,  7,7,  7,7,  7,7,  7,7,  7,7,  7,7,  7,7,  7,7,  7,7,  7,7,  7,7,  7,7,  7,7,  7,7,  7,7,  7,7  ],
[7,3,  3,3,  3,3,  3,7,  7,7,  7,7,  7,7,  7,7,  7,7,  7,7,  7,7,  7,7,  7,7,  7,7,  7,7,  7,7,  7,7,  7,7,  7,7,  7,7,  7,7,  7,7,  7,7,  7,7,  7,7,  7,7,  7,7,  7,7,  7,7,  7,7  ],

[3,3,  3,3,  3,3,  7,7,  7,7,  7,7,  7,7,  7,7,  7,7,  7,7,  7,7,  7,7,  7,7,  7,7,  7,7,  7,7,  7,7,  7,7,  7,7,  7,7,  7,7,  7,7,  7,7,  7,7,  2,2,  7,7,  5,5,  7,7,  7,7,  7,7  ],
[3,3,  3,7,  7,7,  7,7,  7,7,  7,7,  7,7,  7,7,  7,7,  7,0,  0,0,  0,7,  7,7,  7,7,  7,7,  7,7,  7,7,  1,1,  7,7,  7,7,  7,7,  7,7,  7,7,  7,7,  2,2,  7,7,  5,5,  7,7,  7,7,  7,7  ],

[3,3,  7,7,  7,7,  7,7,  7,2,  2,7,  7,7,  7,7,  7,0,  0,0,  0,0,  0,7,  7,7,  7,7,  7,7,  7,7,  7,7,  1,1,  7,7,  7,7,  7,7,  7,7,  7,7,  7,7,  7,7,  7,7,  7,7,  7,7,  7,7,  7,7  ],
[7,7,  7,7,  7,7,  7,7,  7,2,  2,7,  7,7,  7,7,  7,0,  0,0,  0,0,  0,7,  7,7,  7,7,  7,7,  7,7,  7,7,  7,7,  7,7,  7,7,  7,7,  7,7,  7,7,  7,7,  7,7,  7,7,  7,7,  7,7,  7,7,  7,7  ],

[7,7,  7,7,  7,7,  7,7,  7,7,  7,7,  7,7,  7,7,  7,7,  7,7,  7,7,  7,7,  7,7,  7,7,  7,7,  7,7,  7,7,  7,7,  7,7,  7,7,  7,7,  7,7,  7,7,  7,7,  7,7,  7,7,  7,7,  7,7,  7,7,  3,3  ],
[7,7,  7,7,  7,7,  7,7,  7,7,  7,7,  7,7,  7,7,  7,7,  7,7,  7,7,  7,7,  7,7,  7,7,  7,7,  7,7,  7,7,  7,7,  7,7,  7,7,  7,7,  7,7,  7,7,  7,7,  7,7,  7,7,  7,7,  7,7,  3,3,  3,3  ],

[7,7,  7,7,  7,7,  7,7,  7,7,  7,7,  7,7,  7,7,  7,7,  7,7,  7,7,  7,7,  7,7,  7,7,  7,7,  7,7,  7,7,  7,7,  7,7,  7,7,  7,7,  7,7,  7,7,  7,7,  7,7,  7,7,  7,7,  7,3,  3,3,  3,3  ],
[7,7,  7,7,  7,7,  7,7,  7,7,  7,7,  7,7,  7,7,  7,7,  7,7,  7,7,  1,7,  1,7,  7,7,  7,7,  7,7,  7,7,  7,7,  7,7,  7,7,  7,7,  7,7,  7,7,  1,7,  7,7,  7,7,  7,7,  3,3,  3,3,  7,7  ],

[7,7,  7,7,  7,7,  7,7,  7,7,  7,7,  7,7,  7,7,  7,7,  7,7,  7,1,  7,7,  7,1,  7,7,  7,7,  7,7,  7,7,  7,7,  7,7,  7,7,  7,7,  7,7,  7,7,  7,7,  7,7,  7,7,  7,3,  3,3,  3,7,  7,7  ],
[7,7,  7,7,  7,7,  7,7,  7,7,  7,7,  7,7,  7,7,  7,7,  7,7,  7,7,  7,7,  1,1,  7,7,  7,7,  7,1,  1,1,  1,7,  7,7,  7,7,  7,7,  7,7,  7,7,  7,7,  3,3,  3,7,  3,3,  3,3,  7,7,  7,7  ],

[7,7,  7,7,  7,7,  7,7,  7,7,  7,7,  1,1,  1,2,  2,1,  1,7,  7,7,  7,7,  7,7,  7,7,  7,7,  7,1,  7,7,  1,7,  7,7,  7,7,  7,1,  1,1,  1,1,  3,3,  3,3,  3,3,  3,3,  3,7,  7,7,  7,7  ],
[7,7,  7,7,  7,7,  7,7,  7,7,  7,1,  1,3,  3,3,  3,3,  3,3,  3,3,  3,3,  3,3,  7,7,  7,7,  7,1,  1,1,  1,7,  7,7,  7,7,  1,3,  3,3,  3,3,  3,3,  3,3,  3,3,  3,3,  7,7,  7,7,  7,7  ],

[7,1,  1,7,  7,7,  7,7,  7,7,  3,3,  3,3,  3,3,  3,3,  3,3,  3,3,  3,3,  3,3,  3,3,  3,7,  7,7,  7,7,  7,7,  7,7,  3,3,  3,3,  3,3,  3,3,  3,3,  7,7,  7,7,  7,7,  7,7,  7,7,  7,7  ],
[7,1,  1,7,  7,7,  7,7,  3,3,  3,3,  3,3,  7,7,  7,7,  7,7,  7,7,  7,7,  3,3,  3,3,  3,3,  3,3,  3,3,  3,3,  3,3,  3,3,  3,3,  3,7,  7,7,  7,7,  7,7,  7,7,  7,7,  7,7,  7,7,  7,7  ],

[7,7,  7,7,  7,7,  7,3,  3,3,  3,3,  7,7,  7,7,  7,7,  7,7,  7,7,  7,7,  7,7,  7,3,  3,3,  3,3,  3,3,  3,3,  3,3,  3,3,  7,7,  7,7,  7,7,  7,7,  7,7,  7,7,  7,7,  7,7,  7,7,  7,7  ],
[7,7,  7,7,  7,7,  7,3,  3,3,  7,7,  7,7,  7,2,  1,7,  7,7,  7,7,  7,7,  7,7,  7,7,  7,7,  7,7,  7,7,  7,7,  7,7,  7,7,  7,7,  7,7,  7,7,  7,7,  7,2,  7,7,  7,7,  7,7,  7,7,  7,7  ],

[7,7,  7,7,  7,7,  3,3,  3,7,  7,7,  7,7,  1,7,  7,7,  7,7,  7,7,  7,7,  7,7,  7,7,  7,7,  7,7,  7,7,  7,7,  7,7,  7,7,  7,7,  7,7,  7,7,  7,7,  7,2,  7,7,  7,7,  7,7,  7,7,  7,7  ],
[7,7,  7,7,  7,7,  3,3,  3,7,  7,7,  7,7,  7,7,  7,7,  7,7,  7,7,  7,7,  7,7,  7,7,  7,7,  7,7,  7,7,  7,7,  7,7,  7,7,  7,7,  7,7,  7,7,  7,7,  7,7,  2,7,  7,7,  7,7,  7,7,  7,7  ],

[7,7,  7,7,  7,3,  3,3,  7,7,  7,5,  5,6,  5,6,  5,6,  5,6,  5,6,  5,6,  5,6,  5,6,  5,6,  5,6,  5,6,  5,6,  5,6,  5,6,  5,6,  5,6,  5,6,  5,6,  5,7,  7,7,  7,7,  7,7,  7,7,  7,7  ],
[7,7,  7,7,  7,3,  3,3,  7,7,  7,6,  5,5,  6,5,  6,5,  6,5,  6,5,  6,5,  6,5,  6,5,  6,5,  6,5,  6,5,  6,5,  6,5,  6,5,  6,5,  6,5,  6,5,  6,5,  5,7,  7,7,  7,7,  7,7,  7,7,  7,7  ],

[7,7,  7,7,  3,3,  3,7,  7,7,  7,5,  6,0,  0,0,  0,0,  0,0,  0,0,  0,2,  2,0,  0,0,  0,0,  0,2,  2,0,  0,0,  0,0,  0,0,  0,0,  0,0,  0,0,  0,6,  5,7,  7,7,  7,7,  7,7,  7,7,  7,7  ],
[7,7,  7,7,  3,3,  3,7,  7,7,  7,6,  5,0,  0,0,  0,0,  0,0,  0,0,  0,2,  2,0,  0,0,  0,0,  0,2,  2,0,  0,0,  0,0,  0,0,  0,0,  0,0,  0,0,  0,5,  6,7,  7,7,  7,7,  7,7,  7,7,  7,7  ],

[7,7,  7,3,  3,3,  7,7,  7,7,  7,5,  6,0,  0,1,  1,0,  0,2,  2,0,  0,1,  1,0,  0,0,  0,0,  0,1,  1,0,  0,1,  1,0,  0,1,  1,0,  0,1,  1,0,  0,6,  5,7,  7,7,  7,0,  0,0,  7,7,  7,7  ],
[7,7,  7,3,  3,3,  7,7,  7,7,  7,6,  5,0,  0,1,  1,0,  0,2,  2,0,  0,1,  1,0,  0,0,  0,0,  0,1,  1,0,  0,1,  1,0,  0,1,  1,0,  0,1,  1,0,  0,5,  6,7,  7,7,  7,0,  1,1,  7,7,  7,7  ],

[7,7,  3,3,  3,7,  7,7,  7,7,  7,5,  6,0,  0,1,  1,0,  0,0,  0,0,  0,1,  1,0,  0,0,  0,1,  1,1,  1,0,  0,1,  1,0,  0,1,  1,2,  2,1,  1,0,  0,6,  5,7,  7,7,  7,0,  0,1,  7,7,  7,7  ],
[7,7,  3,3,  3,7,  7,7,  7,7,  7,6,  5,0,  0,1,  1,0,  0,0,  0,0,  0,1,  1,0,  0,0,  0,1,  1,1,  1,0,  0,1,  1,0,  0,1,  1,2,  2,1,  1,0,  0,5,  6,7,  7,7,  7,7,  0,0,  7,7,  7,7  ],

[7,3,  3,3,  7,7,  7,7,  7,7,  7,5,  6,0,  0,0,  0,0,  0,1,  1,0,  0,0,  0,0,  0,0,  0,2,  2,0,  0,0,  0,0,  0,0,  0,2,  2,4,  4,0,  0,0,  0,6,  5,7,  7,7,  7,7,  7,7,  7,7,  7,7  ],
[7,3,  3,3,  7,7,  7,7,  7,7,  7,6,  5,0,  0,0,  0,0,  0,1,  1,0,  0,0,  0,0,  0,0,  0,2,  2,0,  0,0,  0,0,  0,0,  0,2,  2,4,  4,0,  0,0,  0,5,  6,7,  7,7,  7,7,  7,7,  7,7,  7,7  ],

[0,0,  0,0,  7,7,  7,7,  7,7,  7,5,  6,0,  0,0,  0,0,  0,0,  0,0,  0,0,  0,0,  0,0,  0,0,  0,0,  0,2,  2,0,  0,0,  0,3,  3,4,  4,3,  3,3,  3,6,  5,7,  7,7,  7,7,  7,7,  7,7,  7,7  ],
[0,0,  0,0,  7,7,  7,7,  7,7,  7,6,  5,0,  0,0,  0,0,  0,0,  0,0,  0,0,  0,0,  0,0,  0,0,  0,0,  0,2,  2,0,  0,0,  0,3,  3,4,  4,3,  3,3,  3,5,  6,7,  7,7,  7,7,  7,7,  7,7,  7,7  ],

[7,3,  3,3,  7,7,  7,7,  7,7,  7,5,  6,4,  4,4,  4,1,  1,1,  1,3,  3,1,  1,4,  4,4,  4,4,  4,2,  2,0,  0,0,  0,1,  1,1,  1,0,  0,1,  1,0,  0,6,  5,7,  7,7,  7,7,  7,7,  7,7,  3,3  ],
[7,3,  3,3,  7,7,  7,7,  7,7,  7,6,  5,4,  4,4,  4,1,  1,1,  1,3,  3,1,  1,4,  4,4,  4,4,  4,2,  2,0,  0,0,  0,1,  1,1,  1,0,  0,0,  0,0,  0,5,  6,7,  7,7,  7,7,  7,7,  7,3,  3,3  ],

[7,7,  3,3,  7,7,  7,7,  7,7,  7,5,  6,0,  0,0,  0,0,  0,0,  0,0,  0,1,  1,4,  4,1,  1,0,  0,1,  1,0,  0,0,  0,0,  0,0,  0,0,  0,0,  0,0,  0,6,  5,7,  7,7,  7,7,  7,7,  3,3,  3,3  ],
[7,7,  3,3,  3,7,  7,7,  7,7,  7,6,  5,0,  0,0,  0,0,  0,0,  0,0,  0,1,  1,4,  4,1,  1,0,  0,1,  1,0,  0,0,  0,0,  0,0,  0,0,  0,1,  1,0,  0,5,  6,7,  7,7,  7,7,  7,7,  3,3,  3,7  ],

[7,7,  3,3,  3,7,  7,7,  7,7,  7,5,  6,2,  2,1,  1,1,  1,1,  1,0,  0,1,  1,0,  0,1,  1,1,  1,1,  1,0,  0,1,  1,1,  1,1,  1,2,  2,1,  1,4,  4,6,  5,7,  7,7,  7,7,  7,3,  3,3,  7,7  ],
[7,7,  7,3,  3,7,  7,7,  7,7,  7,6,  5,2,  2,1,  1,1,  1,1,  1,0,  0,1,  1,0,  0,1,  1,1,  1,1,  1,0,  0,1,  1,1,  1,1,  1,2,  2,1,  1,4,  4,5,  6,7,  7,7,  7,7,  7,3,  3,3,  7,7  ],

[7,7,  3,3,  3,7,  7,7,  7,7,  7,5,  6,0,  0,1,  1,1,  1,1,  1,0,  0,0,  0,0,  0,0,  0,0,  0,0,  0,0,  0,0,  0,0,  0,0,  0,0,  0,0,  0,4,  4,6,  5,7,  7,7,  7,7,  7,3,  3,7,  7,7  ],
[7,3,  3,3,  3,7,  7,7,  7,7,  7,6,  5,0,  0,1,  1,3,  0,0,  0,0,  0,0,  0,0,  0,0,  1,1,  1,1,  0,0,  0,0,  0,0,  0,0,  0,0,  0,0,  0,4,  4,5,  6,7,  7,7,  7,7,  7,3,  3,7,  7,7  ],

[3,3,  3,3,  7,7,  7,7,  7,7,  7,5,  6,0,  0,1,  1,3,  3,3,  3,0,  0,1,  1,0,  0,0,  1,9,  9,1,  0,0,  0,1,  1,1,  1,1,  1,1,  1,1,  1,0,  0,6,  5,7,  7,7,  7,7,  7,3,  3,7,  7,7  ],
[3,3,  3,7,  7,7,  7,7,  7,7,  7,6,  5,0,  0,1,  1,3,  3,0,  0,0,  0,1,  1,0,  0,0,  1,9,  9,1,  0,0,  0,1,  1,1,  1,1,  1,1,  1,1,  1,0,  0,5,  6,7,  7,7,  7,7,  7,3,  3,7,  7,7  ],

[3,7,  7,7,  7,7,  7,7,  7,7,  7,5,  6,5,  6,5,  6,5,  6,5,  6,5,  6,5,  6,5,  6,5,  6,5,  6,5,  6,5,  6,5,  6,5,  6,5,  6,5,  6,5,  6,5,  6,5,  5,7,  7,7,  7,7,  7,3,  3,7,  7,7  ],
[7,7,  7,7,  7,7,  7,7,  7,7,  7,6,  5,6,  5,6,  5,6,  5,6,  5,6,  5,6,  5,6,  5,6,  5,6,  5,6,  5,6,  5,6,  5,6,  5,6,  5,6,  5,6,  5,6,  5,5,  6,7,  7,7,  7,7,  7,3,  3,7,  7,7  ],

[7,7,  7,7,  7,7,  7,7,  7,3,  7,7,  7,7,  7,7,  7,7,  7,7,  7,7,  7,7,  7,7,  7,7,  7,7,  7,7,  7,7,  7,7,  7,7,  7,7,  7,7,  7,7,  7,7,  7,7,  7,7,  2,7,  7,7,  7,3,  3,7,  7,7  ],
[7,7,  7,7,  7,7,  7,7,  7,3,  3,7,  7,7,  7,7,  7,7,  7,7,  7,7,  7,7,  7,7,  7,7,  7,7,  7,7,  7,7,  7,7,  7,7,  7,7,  7,7,  7,7,  7,7,  7,2,  2,2,  7,7,  7,7,  7,3,  3,7,  7,7  ]

]
    },
    {
        "spawnPoints": [[6,36],[20,36],[24, 36],[38, 36]],
        "playerSpawnsPos": [{"x": 18, "y": 54}, {"x": 26, "y": 54}],
        "npc": [0, 0, 0, 0, 0, 0, 0, 0, 0, 0, 0, 0, 0, 0, 0, 0, 0, 0, 0, 0],
        "map": [[7,7,  7,7,  7,7,  7,7,  7,7,  7,7,  7,7,  7,7,  7,7,  7,7,  7,7,  7,7,  7,7,  7,7,  7,7,  7,7,  7,7,  7,7,  7,7,  7,7,  7,7,  7,7,  7,7  ],
        [7,7,  7,7,  7,7,  7,7,  7,7,  7,7,  7,7,  7,7,  7,7,  7,7,  7,7,  7,7,  7,7,  7,7,  7,7,  7,7,  7,7,  7,7,  7,7,  7,7,  7,7,  7,7,  7,7  ],
        
        [7,7,  7,7,  7,7,  7,7,  7,7,  7,7,  7,7,  7,7,  7,7,  7,7,  7,7,  7,7,  7,7,  7,7,  7,7,  7,7,  7,7,  7,7,  7,7,  7,7,  7,7,  7,7,  7,7  ],
        [7,7,  7,7,  7,7,  7,7,  7,7,  7,7,  7,7,  7,7,  7,7,  7,7,  7,7,  7,7,  7,7,  7,7,  7,7,  7,7,  7,7,  7,7,  7,7,  7,7,  7,7,  7,7,  7,7  ],
        
        [7,7,  7,7,  7,7,  7,7,  7,7,  7,7,  7,7,  7,7,  7,7,  7,7,  7,7,  7,7,  7,7,  7,7,  7,7,  7,7,  7,7,  7,7,  7,7,  7,7,  7,7,  7,7,  7,7  ],
        [7,7,  7,7,  7,7,  7,7,  7,7,  7,7,  7,7,  7,7,  7,7,  7,7,  7,7,  2,2,  7,7,  7,7,  7,7,  7,0,  5,5,  5,5,  5,0,  7,7,  7,7,  7,7,  7,7  ],
        
        [7,7,  7,7,  7,7,  7,7,  7,7,  7,7,  7,7,  7,7,  7,7,  7,2,  2,2,  2,7,  7,7,  7,7,  7,7,  7,0,  5,7,  7,7,  5,0,  7,7,  7,7,  7,7,  7,7  ],
        [7,7,  7,7,  7,7,  7,7,  7,7,  7,7,  7,7,  7,7,  2,2,  2,2,  7,7,  7,7,  7,7,  7,7,  7,7,  7,0,  5,7,  7,7,  5,0,  7,7,  7,7,  7,7,  7,7  ],
        
        [7,7,  7,7,  7,7,  7,7,  7,7,  7,7,  7,7,  7,7,  2,7,  7,7,  7,7,  7,7,  7,7,  7,7,  7,7,  7,0,  5,6,  5,6,  5,0,  7,7,  7,7,  7,7,  7,7  ],
        [7,7,  7,7,  7,7,  7,7,  7,7,  7,7,  7,7,  7,7,  7,7,  7,7,  7,7,  7,1,  1,1,  1,7,  7,7,  7,0,  0,0,  0,0,  0,0,  7,7,  7,7,  7,7,  7,7  ],
        
        [7,7,  7,7,  7,7,  7,7,  7,7,  7,7,  7,7,  7,7,  7,7,  7,7,  7,1,  1,1,  7,7,  7,7,  7,7,  7,7,  7,7,  7,7,  7,7,  7,7,  7,7,  7,7,  7,7  ],
        [7,7,  7,7,  7,7,  7,7,  7,7,  3,3,  3,7,  7,7,  7,7,  7,7,  1,1,  7,7,  7,7,  7,7,  7,7,  7,7,  7,7,  7,7,  7,7,  7,7,  7,7,  7,7,  7,7  ],
        
        [7,7,  7,7,  7,7,  3,3,  3,3,  3,3,  3,3,  7,7,  7,7,  7,7,  7,7,  7,7,  7,7,  7,7,  7,7,  7,7,  7,7,  7,7,  7,7,  7,7,  7,7,  7,7,  7,7  ],
        [7,7,  7,7,  7,3,  3,3,  3,3,  3,3,  3,3,  7,7,  7,7,  7,7,  7,7,  7,7,  7,7,  7,7,  7,7,  7,7,  7,7,  7,7,  7,7,  7,7,  7,7,  7,7,  7,7  ],
        
        [7,7,  7,7,  3,3,  3,3,  3,3,  3,3,  3,3,  3,7,  7,7,  7,7,  7,7,  7,7,  7,7,  7,7,  7,7,  7,7,  7,7,  7,7,  7,7,  7,7,  7,7,  7,7,  7,7  ],
        [7,7,  7,3,  3,3,  3,0,  0,0,  3,3,  3,3,  3,7,  7,7,  7,7,  7,7,  7,7,  7,7,  7,7,  0,0,  7,7,  7,7,  7,7,  7,7,  7,7,  7,7,  7,7,  7,7  ],
        
        [7,7,  3,3,  3,3,  0,0,  0,3,  3,3,  3,7,  7,7,  7,7,  7,7,  7,7,  7,7,  7,7,  0,0,  0,0,  0,7,  7,7,  7,7,  7,7,  7,7,  7,7,  7,7,  7,7  ],
        [7,7,  3,3,  3,3,  3,0,  0,3,  3,3,  7,7,  7,7,  7,7,  7,7,  7,7,  7,7,  7,0,  0,1,  1,1,  0,0,  7,7,  7,7,  7,7,  7,7,  7,7,  7,7,  7,7  ],
        
        [7,7,  7,3,  3,3,  3,3,  3,3,  3,7,  7,7,  7,7,  7,7,  7,7,  7,7,  7,7,  0,0,  0,1,  0,1,  0,0,  0,7,  7,7,  7,7,  7,7,  7,7,  7,7,  7,7  ],
        [7,7,  7,3,  3,3,  3,3,  3,3,  7,7,  7,7,  1,7,  7,7,  7,7,  7,7,  7,0,  0,0,  1,0,  0,0,  0,0,  7,7,  7,7,  7,7,  7,7,  7,7,  7,7,  7,7  ],
        
        [7,7,  7,7,  3,3,  3,3,  3,7,  7,7,  7,1,  4,4,  7,7,  7,7,  7,7,  7,7,  0,0,  0,0,  1,7,  7,7,  7,7,  7,7,  5,7,  7,7,  7,7,  7,7,  7,7  ],
        [7,7,  7,7,  7,7,  3,7,  7,7,  7,7,  1,4,  4,1,  7,7,  7,7,  7,7,  7,7,  0,7,  0,7,  7,7,  7,7,  7,7,  7,7,  7,5,  7,7,  7,7,  7,7,  7,7  ],
        
        [7,7,  7,7,  7,7,  7,7,  7,7,  7,1,  4,4,  1,7,  7,7,  7,7,  7,7,  7,7,  7,7,  7,7,  7,7,  7,7,  7,7,  7,7,  7,7,  5,7,  7,7,  7,7,  7,7  ],
        [7,7,  7,7,  7,7,  7,7,  7,7,  7,7,  4,1,  7,7,  7,7,  7,7,  7,7,  7,7,  7,7,  7,7,  7,7,  7,7,  7,7,  7,7,  7,7,  5,6,  7,7,  7,7,  7,7  ],
        
        [7,7,  7,7,  7,7,  7,7,  7,7,  7,7,  1,7,  7,7,  7,7,  7,7,  7,7,  7,7,  7,7,  7,7,  7,7,  7,7,  7,7,  7,7,  7,7,  7,7,  7,7,  7,7,  7,7  ],
        [7,7,  7,7,  7,7,  7,7,  7,7,  7,7,  7,7,  7,7,  7,7,  0,0,  0,0,  0,0,  0,0,  0,7,  7,7,  7,7,  7,7,  7,7,  7,7,  7,7,  7,7,  7,7,  7,7  ],
        
        [7,7,  7,7,  7,7,  7,7,  7,7,  7,7,  7,7,  7,7,  7,7,  0,1,  0,1,  0,1,  1,1,  0,7,  7,7,  0,0,  0,0,  7,7,  7,7,  7,7,  7,7,  7,7,  7,7  ],
        [7,7,  7,7,  7,7,  7,7,  0,0,  0,7,  7,7,  7,7,  7,7,  0,1,  0,1,  0,1,  0,1,  0,7,  7,7,  5,6,  5,6,  7,7,  7,7,  7,7,  7,7,  7,7,  7,7  ],
        
        [7,7,  7,2,  2,7,  7,7,  2,2,  2,7,  7,7,  7,7,  7,7,  0,1,  1,1,  0,1,  0,1,  0,7,  7,7,  7,7,  7,7,  7,7,  7,7,  7,7,  7,7,  7,7,  7,7  ],
        [7,7,  7,7,  7,7,  7,7,  7,7,  7,7,  7,7,  7,7,  7,7,  0,0,  0,0,  0,0,  0,0,  0,7,  7,7,  7,7,  7,7,  7,7,  7,7,  7,7,  7,7,  7,7,  7,7  ],
        
        [7,7,  7,1,  1,7,  7,7,  7,7,  7,7,  7,1,  1,7,  7,7,  7,7,  7,7,  7,7,  7,7,  7,7,  7,7,  7,7,  7,7,  7,7,  1,7,  7,7,  7,7,  7,7,  7,7  ],
        [7,7,  0,0,  1,1,  7,7,  2,1,  2,7,  1,1,  0,0,  0,0,  7,7,  7,7,  7,7,  7,7,  7,7,  2,2,  7,0,  0,0,  0,7,  1,1,  1,1,  2,1,  7,7,  7,7  ],
        
        [7,7,  0,0,  0,0,  0,0,  0,0,  0,0,  0,0,  0,0,  0,0,  0,0,  0,0,  0,0,  0,0,  0,0,  0,0,  0,0,  0,0,  0,0,  0,0,  0,0,  0,0,  0,0,  7,7  ],
        [7,7,  0,0,  0,0,  0,0,  0,0,  0,0,  0,0,  0,0,  0,0,  0,0,  0,0,  0,0,  0,0,  0,0,  0,0,  0,0,  0,0,  0,0,  0,0,  0,0,  0,0,  0,0,  7,7  ],
        
        [7,7,  0,0,  5,6,  6,5,  6,5,  6,5,  6,5,  6,5,  6,5,  6,5,  6,5,  6,5,  6,5,  6,5,  6,5,  6,5,  6,5,  6,5,  6,5,  6,5,  5,6,  0,0,  7,7  ],
        [7,1,  0,0,  5,5,  5,6,  5,6,  5,6,  5,6,  5,6,  5,6,  5,6,  5,6,  5,6,  5,6,  5,6,  5,6,  5,6,  5,6,  5,6,  5,6,  5,6,  5,6,  0,2,  7,7  ],
        
        [7,1,  0,0,  5,6,  0,0,  0,0,  0,0,  0,0,  0,0,  1,1,  0,0,  0,0,  0,0,  0,0,  0,0,  1,1,  1,0,  0,0,  0,0,  0,0,  0,0,  5,6,  0,0,  7,7  ],
        [7,1,  0,0,  5,5,  0,0,  0,0,  0,0,  0,0,  0,0,  1,1,  0,0,  0,0,  0,0,  0,0,  0,0,  1,1,  1,0,  0,0,  0,0,  0,0,  0,0,  5,6,  0,2,  7,7  ],
        
        [1,1,  0,0,  5,6,  1,1,  1,1,  0,0,  1,1,  0,0,  1,1,  0,0,  0,0,  0,0,  0,0,  0,0,  2,2,  1,0,  0,1,  1,1,  1,1,  0,0,  6,6,  0,0,  7,7  ],
        [1,7,  0,0,  5,5,  1,1,  1,1,  0,0,  1,1,  0,0,  1,1,  0,0,  0,0,  0,0,  0,0,  0,0,  2,1,  1,0,  0,1,  1,1,  1,1,  0,0,  5,6,  0,0,  7,7  ],
        
        [7,7,  0,0,  5,6,  0,0,  0,0,  0,0,  1,1,  4,4,  1,1,  0,0,  1,1,  1,1,  1,1,  0,0,  1,1,  1,0,  0,0,  0,0,  0,0,  0,0,  6,6,  0,0,  7,7  ],
        [7,7,  0,0,  5,5,  0,0,  0,0,  0,0,  1,1,  4,4,  1,1,  0,0,  1,1,  1,1,  1,1,  0,0,  1,1,  2,0,  0,0,  0,0,  0,0,  0,0,  5,6,  0,1,  7,7  ],
        
        [7,0,  0,0,  5,6,  0,0,  0,0,  0,0,  1,1,  4,4,  4,4,  0,0,  0,0,  0,0,  0,0,  0,0,  1,2,  2,0,  0,0,  0,0,  0,0,  0,0,  6,6,  0,1,  7,7  ],
        [7,0,  0,0,  5,5,  4,4,  0,0,  0,0,  1,1,  4,4,  4,4,  0,0,  0,0,  0,0,  0,0,  0,0,  2,2,  1,0,  0,0,  1,1,  1,0,  0,0,  5,6,  0,1,  7,7  ],
        
        [7,0,  0,0,  5,6,  4,4,  0,0,  0,0,  1,1,  1,1,  1,1,  0,0,  1,1,  1,1,  1,1,  0,0,  0,0,  0,0,  0,0,  1,1,  1,0,  4,4,  6,6,  0,1,  1,7  ],
        [7,7,  0,0,  5,5,  4,4,  0,0,  0,0,  1,1,  1,1,  1,1,  0,0,  1,1,  1,1,  1,1,  0,0,  0,0,  0,0,  0,0,  1,1,  1,0,  4,4,  5,6,  0,0,  1,7  ],
        
        [7,7,  0,0,  5,6,  4,4,  0,0,  0,0,  0,0,  0,0,  0,0,  0,0,  0,0,  0,0,  0,0,  0,0,  0,4,  4,4,  4,4,  4,0,  0,0,  4,4,  6,6,  0,0,  7,7  ],
        [7,1,  0,0,  5,5,  4,4,  0,0,  0,0,  0,0,  0,0,  0,0,  0,0,  0,0,  0,0,  0,0,  0,0,  0,4,  4,4,  4,4,  4,0,  0,0,  4,4,  5,6,  0,0,  7,7  ],
        
        [7,1,  0,0,  5,6,  4,4,  3,3,  3,3,  1,1,  1,0,  0,1,  1,1,  1,1,  0,0,  1,1,  3,3,  3,2,  2,0,  0,2,  2,1,  1,1,  1,1,  6,6,  0,0,  7,7  ],
        [1,1,  0,0,  5,5,  4,4,  3,3,  3,3,  1,1,  1,0,  0,1,  1,1,  1,1,  0,0,  1,1,  3,3,  3,1,  2,0,  0,2,  1,1,  1,1,  1,1,  5,6,  0,7,  7,7  ],
        
        [1,7,  0,0,  5,6,  4,4,  0,0,  0,0,  0,0,  0,0,  0,0,  0,0,  0,0,  9,9,  0,0,  0,0,  1,1,  1,0,  0,1,  1,1,  0,0,  0,0,  6,6,  0,7,  7,7  ],
        [1,7,  0,0,  5,5,  4,4,  0,0,  0,0,  0,0,  0,0,  0,0,  0,0,  0,0,  9,9,  0,0,  0,0,  0,1,  2,0,  0,2,  1,0,  0,0,  0,0,  5,6,  0,1,  7,7  ],
        
        [7,7,  0,0,  5,6,  1,1,  1,1,  1,0,  0,0,  0,0,  0,0,  0,0,  0,0,  0,0,  0,0,  0,0,  0,2,  2,0,  0,2,  2,0,  0,0,  0,1,  6,6,  0,1,  7,7  ],
        [7,7,  0,0,  5,5,  1,1,  1,1,  1,0,  0,0,  0,0,  0,0,  0,0,  0,0,  1,1,  0,0,  0,0,  0,0,  0,0,  0,0,  0,0,  0,0,  1,1,  5,6,  0,1,  7,7  ],
        
        [7,0,  0,0,  5,6,  1,1,  4,4,  4,0,  0,1,  1,1,  1,1,  0,0,  0,1,  0,0,  1,0,  0,0,  0,0,  0,0,  0,0,  0,0,  0,1,  1,1,  6,6,  0,1,  7,7  ],
        [7,0,  0,0,  5,5,  1,4,  4,4,  4,0,  0,1,  1,1,  1,1,  0,0,  0,1,  0,0,  1,0,  0,0,  0,0,  0,0,  0,0,  0,0,  1,1,  1,1,  5,6,  0,1,  1,7  ],
        
        [2,0,  0,0,  5,6,  6,6,  6,6,  6,6,  6,6,  6,6,  6,6,  6,6,  6,6,  6,6,  6,6,  6,6,  6,6,  6,6,  6,6,  6,6,  6,6,  6,6,  6,6,  0,1,  1,7  ],
        [7,0,  0,0,  5,5,  6,5,  6,5,  6,5,  6,5,  6,5,  6,5,  6,5,  5,5,  6,5,  6,5,  6,5,  6,5,  6,5,  6,5,  6,5,  6,5,  6,5,  6,6,  0,0,  7,7  ],
        
        [7,7,  7,7,  7,7,  7,7,  7,7,  7,7,  7,7,  7,7,  7,7,  7,7,  7,7,  7,7,  7,7,  7,7,  7,7,  7,7,  7,7,  7,7,  7,7,  7,7,  7,7,  7,2,  7,7  ],
        [7,7,  7,7,  7,7,  7,7,  7,7,  7,7,  7,7,  7,7,  7,7,  7,7,  7,7,  7,7,  7,7,  7,7,  7,7,  7,7,  7,7,  7,7,  7,7,  7,7,  7,7,  7,7,  7,7  ]
        
        ]
    },
    {
        "spawnPoints": [[0,0],[32,0],[20, 0],[14, 0]],
        "playerSpawnsPos": [{"x": 20, "y": 18}, {"x": 12, "y": 18}],
        "npc": [1,1,0,0,0,1,0,0,0,2,1,1,0,1,0,2,1,1,2,0],
        "map": [[0,0,    0,0,    0,0,    0,0,    1,1,    0,0,    0,0,    0,0,    0,0,    0,0,    0,0,    0,0,    1,1,    0,0,    0,0,    0,0,    0,0    ],
                [0,0,    0,0,    0,0,    0,0,    1,1,    0,0,    0,0,    0,0,    0,0,    0,0,    0,0,    0,0,    1,1,    0,0,    0,0,    0,0,    0,0    ],
                
                [0,0,    0,0,    0,0,    0,0,    0,0,    0,0,    0,0,    0,0,    0,0,    0,0,    0,0,    0,0,    0,0,    0,0,    0,0,    0,0,    0,0    ],
                [0,0,    0,0,    0,0,    0,0,    0,0,    0,0,    0,0,    0,0,    0,0,    0,0,    0,0,    0,0,    0,0,    0,0,    0,0,    0,0,    0,0    ],
                
                [0,0,    0,0,    0,0,    0,0,    0,0,    0,0,    0,0,    0,0,    0,0,    0,0,    0,0,    0,0,    0,0,    0,0,    0,0,    0,0,    0,0    ],
                [0,0,    0,0,    0,0,    0,0,    0,0,    0,0,    4,4,    2,2,    2,2,    2,2,    0,0,    0,0,    0,0,    0,0,    0,0,    0,4,    4,4    ],
                
                [0,0,    2,1,    0,0,    0,0,    0,0,    0,0,    4,4,    2,2,    2,2,    2,2,    0,0,    0,0,    0,0,    0,0,    0,0,    4,2,    4,4    ],
                [0,0,    2,2,    1,0,    0,0,    2,2,    0,0,    4,4,    2,2,    0,0,    0,0,    0,0,    0,0,    0,2,    2,0,    0,4,    2,2,    4,4    ],
                
                [1,1,    2,2,    2,1,    1,1,    2,2,    0,0,    4,4,    2,2,    0,0,    0,0,    0,0,    0,0,    0,2,    2,0,    4,2,    2,2,    4,4    ],
                [0,0,    2,2,    1,0,    0,0,    0,0,    4,4,    4,4,    2,2,    0,0,    2,2,    2,2,    2,0,    0,0,    0,0,    4,2,    2,2,    4,4    ],
                
                [0,0,    2,1,    0,0,    0,0,    0,0,    4,4,    4,4,    2,2,    0,0,    2,2,    2,2,    2,0,    0,0,    0,0,    0,4,    2,2,    4,4    ],
                [0,0,    0,0,    0,0,    0,0,    0,0,    4,4,    3,3,    2,2,    0,0,    2,2,    1,1,    0,0,    0,0,    0,0,    0,0,    4,2,    4,4    ],
                
                [0,0,    0,0,    0,0,    0,0,    0,0,    4,4,    3,3,    2,2,    1,1,    2,2,    1,0,    0,0,    0,0,    0,0,    0,0,    0,1,    4,4    ],
                [0,0,    0,2,    2,1,    1,2,    2,0,    0,0,    0,0,    0,0,    0,0,    0,0,    0,0,    0,0,    0,0,    0,0,    0,0,    0,1,    0,0    ],
                
                [0,0,    0,0,    0,0,    0,0,    2,0,    0,0,    0,0,    0,0,    0,0,    0,0,    0,0,    0,0,    2,2,    2,2,    2,0,    0,1,    0,0    ],
                [0,0,    0,0,    0,0,    0,0,    2,0,    0,0,    0,0,    0,0,    0,0,    0,0,    0,0,    0,0,    0,0,    2,2,    0,0,    0,1,    0,0    ],
                
                [0,0,    0,0,    0,0,    0,0,    0,0,    0,0,    0,0,    0,0,    0,0,    0,0,    0,0,    0,0,    0,0,    2,0,    0,0,    0,1,    0,0    ],
                [0,0,    0,0,    0,0,    0,0,    0,0,    0,0,    0,0,    0,1,    1,1,    1,0,    0,0,    0,0,    0,0,    2,1,    1,1,    1,1,    0,0    ],
                
                [2,2,    1,0,    0,0,    0,0,    0,0,    0,0,    0,0,    0,1,    9,9,    1,0,    0,0,    0,0,    0,0,    0,0,    0,0,    0,0,    0,0    ],
                [2,2,    1,1,    0,0,    0,0,    0,0,    0,0,    0,0,    0,1,    9,9,    1,0,    0,0,    0,0,    0,0,    0,0,    0,0,    0,0,    0,0    ]]
    },
    {
        "spawnPoints": [[0,0],[8,0],[24, 0],[32, 0]],
        "playerSpawnsPos": [{"x": 12, "y": 18}, {"x": 20, "y": 18}],
        "npc": [0,0,0,0,1,1,0,0,2,0,1,1,0,1,1,2,2],
        "map": [[0,0,0,0,0,0,0,0,0,0,0,0,0,0,0,0,0,0,0,0,0,0,0,0,0,0,0,0,0,0,0,0,0,0],
                [0,0,0,0,0,0,0,0,0,0,0,0,0,0,0,0,0,0,0,0,0,0,0,0,0,0,0,0,0,0,0,0,0,0],
                [0,0,1,1,0,0,1,1,0,0,1,1,0,0,0,1,1,1,1,0,0,0,1,1,0,0,1,1,0,0,1,1,0,0],
                [0,0,1,1,0,0,1,1,0,0,1,1,0,0,0,1,1,1,1,0,0,0,1,1,0,0,1,1,0,0,1,1,0,0],
                [0,0,1,1,0,0,1,1,0,0,1,1,0,0,0,1,1,1,1,0,0,0,1,1,0,0,1,1,0,0,1,1,0,0],
                [0,0,1,1,0,0,1,1,0,0,1,1,0,0,0,1,1,1,1,0,0,0,1,1,0,0,1,1,0,0,1,1,0,0],
                [0,0,1,1,0,0,1,1,0,0,1,1,0,0,0,1,1,1,1,0,0,0,1,1,0,0,1,1,0,0,1,1,0,0],
                [0,0,1,1,0,0,1,1,0,0,1,1,0,0,0,1,1,1,1,0,0,0,1,1,0,0,1,1,0,0,1,1,0,0],
                [4,4,4,4,0,0,0,0,0,0,0,0,0,0,0,0,0,0,0,0,0,0,0,0,0,0,0,0,0,0,4,4,4,4],
                [4,4,4,4,0,0,0,0,0,0,0,0,0,0,0,0,0,0,0,0,0,0,0,0,0,0,0,0,0,0,4,4,4,4],
                [4,4,1,1,3,3,3,3,3,3,1,1,0,0,0,0,0,0,0,0,0,0,1,1,3,3,3,3,3,3,1,1,4,4],
                [4,4,1,1,3,3,3,3,3,3,1,1,0,0,0,0,0,0,0,0,0,0,1,1,3,3,3,3,3,3,1,1,4,4],
                [4,4,4,4,0,0,0,0,0,0,0,0,0,0,0,0,0,0,0,0,0,0,0,0,0,0,0,0,0,0,4,4,4,4],
                [4,4,4,4,0,0,0,0,0,0,0,0,0,0,0,0,0,0,0,0,0,0,0,0,0,0,0,0,0,0,4,4,4,4],
                [0,0,1,1,0,0,1,1,0,0,1,1,0,0,0,1,1,1,1,0,0,0,1,1,0,0,1,1,0,0,1,1,0,0],
                [0,0,1,1,0,0,1,1,0,0,1,1,0,0,0,0,0,0,0,0,0,0,1,1,0,0,1,1,0,0,1,1,0,0],
                [0,0,1,1,0,0,1,1,0,0,1,1,0,0,0,0,0,0,0,0,0,0,1,1,0,0,1,1,0,0,1,1,0,0],
                [0,0,1,1,0,0,1,1,0,0,1,1,0,0,0,1,1,1,1,0,0,0,1,1,0,0,1,1,0,0,1,1,0,0],
                [0,0,0,0,0,0,0,0,0,0,0,0,0,0,0,1,9,9,1,0,0,0,0,0,0,0,0,0,0,0,0,0,0,0],
                [0,0,0,0,0,0,0,0,0,0,0,0,0,0,0,1,9,9,1,0,0,0,0,0,0,0,0,0,0,0,0,0,0,0]]
    },
    {
        "spawnPoints": [[0,0],[7,0],[0, 7],[16, 0]],
        "playerSpawnsPos": [{"x": 22, "y": 18}, {"x": 30, "y": 18}],
        "npc": [1,1,0,2,1,1,0,2,0,0,1,2,0,1,1,0,2,1,1,2],
        "map": [[0,0,  0,0,  0,0,  0,0,  0,0,  0,0,  0,1,  0,1,  4,4,  4,4,  4,4,  4,4,  0,0,  0,0,  0,0,  0,0,  0,0  ],
                [0,0,  0,0,  0,0,  0,0,  0,0,  0,0,  0,1,  0,1,  4,4,  4,4,  4,4,  4,4,  0,0,  0,0,  0,0,  0,0,  0,0  ],
                
                [0,0,  1,1,  1,1,  1,1,  1,1,  0,0,  0,0,  0,0,  0,0,  0,0,  1,1,  0,0,  0,0,  0,1,  1,1,  0,0,  0,0  ],
                [0,0,  0,0,  0,0,  1,0,  0,0,  0,0,  0,0,  0,0,  0,0,  0,0,  1,1,  0,0,  0,1,  1,1,  1,1,  1,1,  0,0  ],
                
                [0,0,  0,0,  0,0,  1,0,  0,0,  0,0,  0,1,  0,2,  0,0,  0,0,  1,1,  0,0,  0,1,  1,1,  1,1,  1,1,  0,0  ],
                [0,0,  0,0,  0,0,  0,0,  0,0,  0,0,  1,1,  2,2,  2,0,  0,0,  0,0,  0,0,  0,0,  0,0,  0,0,  0,0,  0,0  ],
                
                [0,0,  0,0,  0,0,  0,0,  0,0,  0,0,  0,1,  0,2,  0,0,  0,0,  0,0,  0,0,  0,0,  0,0,  0,0,  0,0,  0,0  ],
                [0,0,  1,1,  1,1,  1,1,  1,0,  0,0,  0,0,  0,0,  0,0,  0,0,  0,0,  2,1,  1,1,  1,0,  0,0,  1,1,  0,0  ],
                
                [0,0,  3,3,  0,0,  0,0,  0,0,  0,0,  0,0,  0,0,  0,0,  0,0,  0,0,  2,1,  1,1,  1,0,  0,0,  1,1,  0,0  ],
                [0,0,  3,3,  0,0,  0,0,  0,0,  0,0,  0,0,  0,0,  0,0,  0,2,  0,0,  1,1,  0,0,  0,0,  0,0,  1,1,  0,0  ],
                
                [0,0,  3,3,  0,0,  0,0,  0,1,  1,1,  1,1,  1,1,  1,0,  0,2,  0,0,  1,1,  0,0,  0,0,  0,0,  1,1,  0,0  ],
                [0,0,  3,3,  0,0,  0,0,  0,1,  1,1,  1,2,  2,0,  0,0,  0,0,  0,0,  0,0,  0,0,  2,2,  0,0,  0,0,  0,0  ],
                
                [0,0,  3,3,  0,0,  0,0,  0,0,  0,0,  1,2,  2,0,  0,0,  0,0,  0,0,  0,0,  0,0,  2,2,  0,0,  0,0,  0,0  ],
                [0,0,  1,1,  1,0,  0,0,  0,0,  0,0,  0,1,  1,0,  0,2,  2,3,  3,3,  3,1,  0,0,  0,0,  0,0,  1,1,  3,3  ],
                
                [0,0,  4,4,  4,4,  4,4,  4,4,  4,4,  4,4,  4,0,  0,2,  2,3,  3,3,  3,1,  0,0,  0,0,  0,0,  1,1,  3,3  ],
                [0,0,  4,4,  4,4,  4,4,  4,4,  4,4,  4,4,  4,0,  0,1,  1,0,  0,0,  0,0,  0,0,  0,0,  0,0,  0,0,  0,0  ],
                
                [0,0,  1,1,  1,1,  1,1,  2,2,  2,4,  4,1,  1,0,  0,1,  1,0,  0,0,  0,0,  0,0,  0,0,  0,0,  0,0,  0,0  ],
                [0,0,  1,1,  1,1,  1,1,  1,1,  2,4,  4,1,  1,0,  0,1,  1,0,  0,0,  0,0,  1,1,  1,1,  0,0,  0,0,  0,0  ],
                
                [0,0,  0,0,  0,0,  0,0,  3,3,  3,0,  0,0,  1,0,  0,0,  0,0,  0,0,  0,0,  1,0,  0,1,  0,0,  0,0,  0,0  ],
                [0,0,  0,0,  0,0,  0,0,  3,3,  3,0,  0,0,  1,0,  0,0,  0,0,  0,0,  0,0,  1,0,  0,1,  0,0,  0,0,  0,0  ]]
    } 
]